.........R#....................
..........#....................
...R#.....#....................
....#.....#................B#..
....#.....#B#########R......#..
....#.....#.#...#B..#.......#..
....#.....#.#...#...#.......#..
###############################
............#...#...#...B#.....
............#..B#...#....#.....
...........B#########R...#.....
.........................#.....
.........................#.....
.........................#.....
........................B#.....
