..........#....................
..........#....................
....#.....#....................
....#.....#.................#..
....#.....#.#########.......#..
....#.....#.#...#...#.......#..
....#.....#.#...#...#.......#..
###############################
............#...#...#....#.....
............#...#...#....#.....
............#########....#.....
.........................#.....
.........................#.....
.........................#.....
.........................#.....
